# default key bindings

Alt-KP+		resolution_increase
Alt-KP- 	resolution_decrease
KP+		brighter
KP- 		darker
Esc		close_gumps
right		scroll_right
left		scroll_left
up		scroll_up
down		scroll_down
home		center_screen
F2		cheat_screen
F3		map_teleport
F4		toggle_fullscreen
F10		show_endgame
F11		show_si_intro
Alt-1		sound_tester
Ctrl-B		shape_browser
B		useitem			761	# Show spellbook
Ctrl-C		create_item		-1	# Create last shape
C		toggle_combat
Ctrl-D		delete_object
E		toggle_eggs
F		useitem			377	# Feed
Alt-G		toggle_god_mode
Ctrl-G		change_gender
H		help
Ctrl-H		cheat_help
Ctrl-Alt-H	party_heal
Alt-I		toggle_infravision
I		inventory
K		try_keys
Ctrl-L		party_increase_level
L		skiplift_decrement
Ctrl-Alt-M	toggle_map_editor
Ctrl-M		create_item		644 -1 100	# Create gold
Shift-Alt-M	play_music		-2	# Previous song
Alt-M		play_music		-1	# Next song
M		useitem			178	# Show map
Alt-N		toggle_naked
Alt-P		toggle_petra
Ctrl-P		repaint
P		useitem			627	# Use lockpick
Alt-Q		quit
Ctrl-R		quickrestore
Ctrl-Alt-S	screenshot
Ctrl-S		quicksave
Alt-S		change_skin
S		save_restore
Ctrl-Alt-T	map_teleport
Ctrl-T		next_time_period
Alt-T		cursor_teleport
T		target_mode
V		about
Alt-W		toggle_wizard_mode
W		useitem			159	# Use watch
Alt-X		quit
Z		stats

Ctrl-Alt-G	grab_actor
Ctrl-Alt-P	pick_pocket
Ctrl-N		npc_numbers
